NO ./textures/maze/maze.xpm
SO ./textures/maze/maze1.xpm
WE ./textures/maze/maze2.xpm
EA ./textures/maze/maze3.xpm

F 25,12,13
C 9,11,40

11111111
10000 11
1111N111
11111111
