NO ./textures/maze/maze.xpm
SO ./textures/maze/maze1.xpm
WE ./textures/maze/maze2.xpm
EA ./textures/maze/nonvabene.xpm

F 25,12,13
C 9,11,40

11111111
10000001
10000001
1000N001
11111111
