111111
100101
10 1001
1100N1
111111