C 66,FF,FF
F 220,100,0

11111111111111111
100000000000111
11111101111111
1111000000111111
11111101111111111
11000000111111
10000001111111111
10000000000001111
1000000N000000001
11111111111111111