
	NO ./textures/boh.xpm
	SO ./textures/osiidiana.xpm
	WE ./textures/text.xpm
	EA ./textures/text1.xpm
	CT ./textures/sunny.xpm
	FT ./textures/wood.xpm
	DO ./textures/wood.xpm

F 10,40,20
1111111111111111111111111111111
1000000000001000000000000001001
1111111111001111111001001111001
1000001000000001001001001000001
1001001001111001001111001111001
1001000000001001000001000000001
1111111001111111111001111111001
1001000000000001001000001001001
1001111001111111001111001001001
1000000000000001001000001001001
1111111001001111001001001001001
10000010010000N1000001001001001
1001111001001001001001001001001
1000000001001000001001000000001
1001001111111001111111111111001
1001000001001000001000001000001
1001001111001111111001001111001
1001000001001000000001001000001
1001111111001001111111001111001
10000000000000010000000010000P1
1111111111111111111111111111111
