
	NO ./textures/boh.xpm
	SO ./textures/osiidiana.xpm
	WE ./textures/text.xpm
	EA ./textures/text1.xpm



C 66,FF,FF
F 220,100,0

11111111111111111
10000000000000111
11111111011111111
11111110001111111
11111100000111111
11111000100011111
11110000000001111
11100000000000111
1100000N00000011
11111111111111111