C 66,FF,FF
F 220,100,0

1111111111111111
1100000100000001111
10000000000000000001
1001000N000000011111
1000000000000001
110000010011111
1111111111111111