
1111111111111111111111111111111111
1000001
11000001
1110N011
100000001
1000000001
111111111