	NO ./textures/maze/maze.xpm
	SO ./textures/maze/maze1.xpm
	WE ./textures/maze/maze2.xpm
	EA ./textures/fire.xpm
	DO ./textures/maze/door_closed.xpm
	
	F 25,12,13
	C 9,11,40

11111111111111111111111111111
10000000000000E00000000000001
10000000000000000000000000001
11111111111111P11111111111111
10000000000000000000000000001
10000000000000000000000000001
10000000000000L00000000000001
10000000000000000000000000001
10000111111110111111111111111
10000100000000000000000000001
10000100000000000000000000001
100001111111111D1111111110001
10000100000000000000000010001
10000100000000N00000000010001
10000111111111111111111110001
10000000000000000000000000001
10000000000000000000000000001
11111111111111111111111111111
