NO ./textures/maze/maze.xpm
SO ./textures/maze/maze1.xpm
WE ./textures/maze/maze2.xpm
EA ./textures/maze/maze3.xpm

F 25,12,13
C 9,11,40

1111111111111111111111111111111
1111000001000001000000000000001
1U0P00L001001111001111D11001111
111100000D000001000000001001001
1111111111001111111111001001001
1000001000000000001000001000001
1001111001001111111111001111111
1001001001000000001001000001001
1001001001111111111001001001001
1000000000001001001000001000001
111100111111100100111D111001111
1000000001000010010000010000001
1111001001001111001111001111001
1000001000000000000001000000001
11D1100100111100100111111D11001
1000001001000001000001000000001
1111001111111111001111001001001
1000000000001000001000001001001
10011111110011110011110011111D1
10000000010010000000000011110N1
1111111111111111111111111111111