	NO ./textures/maze/maze.xpm
	SO ./textures/maze/maze1.xpm
	WE ./textures/maze/maze2.xpm
	EA ./textures/maze/maze3.xpm

	CT ./textures/sunny.xpm
	DC ./textures/maze/door_closed.xpm
	DO ./textures/maze/door_opened.xpm


11111111111111111111111111111
10000000000000000000000000001
10000000000000000000000000001
11111L1111L111SSS111L111011L11
10000000000000000000000000001
10000000000000000000000000001
10000000000000L00000000000001
10000000000000000000000000001
10000111111111111111111111111
10000100000000000000000000001
10000100000000000000000000001
100001111111111D1111111110001
10000100000000000000000010001
10000100000000N00000000010001
10000111111111111111111110001
10000000000000000000000000001
10000000000000000000000000001
11111111111111111111111111111
