NO ./textures/metal/metal.xpm
SO ./textures/metal/metal_window.xpm
WE ./textures/metal/metal_ligth.xpm
EA ./textures/metal/metal_wall.xpm

DO	./textures/metal/metal_door.xpm

C 30,30,30
F 50,50,10

1111111111111111111111111111111
1001001000000000000000000000001
1001001001111001001111001111001
1000000001000001000001001000001
1001001111001111111001111111111
1001001001000001000000000000001
1111001001111001111111111001001
1000001000001000001000001001001
1001001111001111001001001001111
1001000000000001001001000000001
1111111001111111111111111001111
1000000000000001000000001000001
1111001111001001111001111001111
1000001000001000001001001001001
1111111111111111111001001001001
1000001001001001000000000000001
1001111001001001111001111111111
1000000000001000001001001000001
1111001111001001111001001001111
10000000010000000000N0000000001
1111111111111111111111111111111