	NO ./textures/fire.xpm
	SO ./textures/water.xpm
	WE ./textures/cloud.xpm
	EA ./textures/ice.xpm
	CT ./textures/sunny.xpm
	FT ./textures/osiidiana.xpm
	DO ./textures/wood.xpm
C 66,FF,FF
F 220,100,0

11111111111111111111111111
10000000000000000000000001
10000000000000000000000001
10000000000000000000000001
10000000000000000000000001
10000000000000000000000001
1DDDDDDDDDDDDDDDDDDDDDDDD1
10000000000000000000000001
10000000000000000000000001
1000000000000000N000000001
10000000000000000000000001
11111111111111111111111111