NO ./textures/maze/maze.xpm
SO ./textures/maze/maze1.xpm
WE ./textures/maze/maze2.xpm
EA ./textures/maze/maze3.xpm

F 25,12,13
C 9,11,40



111111111111111111111111111111111111111111111111111111111111111111111111111111111111111111111111111111111111111111111
111000100000000000000000000001000101010101010101010101010101010101010101010101010101010101010101010101010101010101001
1U00L0D0000000100000000000000D000101010101010101010101010101010101010101010101010101010101010101010101010101010101001
111111110000001000000000000001000100000000000000000000000000000000000000000000000000000000000000000000000000000000001
10000001000000100000011111D111000101010101010101010101010101010101010101010101010101010101010101010101010101010101001
10001001000000111D111100000001000100000000000000000000000000000000000000000000000000000000000000000000000000000000001
1000100100000000000000D0111001000101010101010101010101010101010101010101010101010101010101010101010101010101010101001
100010010000001000000010001001000100000000000000000000000000000000000000000000000000000000000000000000000000000000001
100010011111111000000010001001000101010101010101010101010101010101010101010101010101010101010101010101010101010101001
100010000000001000000010001001000100000000000000000000000000000000000000000000000000000000000000000000000000000000001
100011D1111111100000001D111D11000101010101010101010101010101010101010101010101010101010101010101010101010101010101001
100000000000000000000010000000000100000000000000000000000000000000000000000000000000000000000000000000000000000000001
100000000000111111110010000000000101010101010101010101010101010101010101010101010101010101010101010101010101010101001
100000000000100000010010000000000100000000000000000000000000000000000000000000000000000000000000000000000000000000001
100000000000101111010010000000000101010101010101010101010101010101010101010101010101010101010101010101010101010101001
100000000000101001010011110000000100000000000000000000000000000000000000000000000000000000000000000000000000000000001
100000000000101001010000010000000101010101010101010101010101010101010101010101010101010101010101010101010101010101001
100000000000101001010000010000000100000000000000000000000000000000000000000000000000000000000000000000000000000000001
100000000000101001011111111111111101010101010101010101010101010101010101010101010101010101010101010101010101010101001
100000000000100000000000000000000100000000000000000000000000000000000000000000000000000000000000000000000000000000001
100000000000111111100000000000000101010101010101010101010101010101010101010101010101010101010101010101010101010101001
100000000000000000100000000000000100000000000000000000000000000000000000000000000000000000000000000000000000000000001
100000000000100000100000000000000101010101010101010101010101010101010101010101010101010101010101010101010101010101001
100000000000100000100000000000000100000000000000000000000000000000000000000000000000000000000000000000000000000000001
100000000000100000100000000000000101010101010101010101010101010101010101010101010101010101010101010101010101010101001
100000000000100000100000000000000100000000000000000000000000000000000000000000000000000000000000000000000000000000001
100000000000111111100000000000000101010101010101010101010101010101010101010101010101010101010101010101010101010101DD1
100000000000000000000000000000000D00000000000000000000000000000000000000000000000000000000000000000000000000000001001
1000000000000000000000000000000001010101010101010101010101010101010101010101010101010101010101010101010101010101010N1
111111111111111111111111111111111111111111111111111111111111111111111111111111111111111111111111111111111111111111111
